[console_scripts]
cloudmgr = slapos.cloudmgr.cloudmgr:main
is-process-older-than-dependency-set = slapos.promise.is_process_older_than_dependency_set:main
cloudlist = slapos.cloudmgr.list:main
monitor.statistic = slapos.monitor.build_statistic:main
is-icmp-packet-lost = slapos.promise.is_icmp_packet_lost:main
runApacheDex = slapos.apachedex:main
runResiliencyUnitTestTestNode = slapos.resiliencytest:runUnitTest
agent = slapos.agent.agent:main
clouddestroy = slapos.cloudmgr.destroy:main
check-error-on-apache-log = slapos.promise.check_error_on_apache_log:main
slaprunnerteststandalone = slapos.runner.runnertest:runStandaloneUnitTest
cloudgetprivatekey = slapos.cloudmgr.getprivatekey:main
equeue = slapos.equeue:main
is-local-tcp-port-opened = slapos.promise.is_local_tcp_port_opened:main
monitor.runpromise = slapos.monitor.runpromise:main
slapos-kill = slapos.systool:kill
zodbpack = slapos.zodbpack:run [zodbpack]
rdiffbackup.genstatrss = slapos.resilient.rdiffBackupStat2RSS:main
networkbench = slapos.networkbench:main
check-re6st-optimal-status = slapos.promise.check_re6st_optimal_status:main
pubsubnotifier = slapos.pubsub.notifier:main
check-apachedex-result = slapos.promise.check_apachedex_result:main
onetimedownload = slapos.onetimedownload:main
check-free-disk = slapos.promise.check_free_disk:main
killpidfromfile = slapos.systool:killpidfromfile
check-feed-as-promise = slapos.checkfeedaspromise:main
qemu-qmp-client = slapos.qemuqmpclient:main
monitor.bootstrap = slapos.monitor.monitor:main
apache-mpm-watchdog = slapos.promise.apache_mpm_watchdog:main
monitor.collect = slapos.monitor.collect:main
htpasswd = slapos.htpasswd:main
lampconfigure = slapos.lamp:run [lampconfigure]
monitor.configwrite = slapos.monitor.monitor_config_write:main
slaprunnertest = slapos.runner.runnertest:main
cloudstart = slapos.cloudmgr.start:main
check-slow-queries-digest-result = slapos.promise.check_slow_queries_digest_result:main
check-computer-memory = slapos.promise.check_computer_memory:main
pubsubserver = slapos.pubsub:main
generatefeed = slapos.generatefeed:main
securedelete = slapos.securedelete:main
onetimeupload = slapos.onetimeupload:main
check-web-page-http-cache-hit = slapos.promise.check_web_page_http_cache_hit:main
runResiliencyScalabilityTestNode = slapos.resiliencytest:runResiliencyTest
cloudstop = slapos.cloudmgr.stop:main
cachechecker = slapos.cachechecker:web_checker_utility
monitor.genstatus = slapos.monitor.globalstate:main
cloudgetpubliciplist = slapos.cloudmgr.getpubliciplist:main

